10,20
@@@@@@@@@@@@@@@@@@@@
@........@@........@
@........@@........@
@..................@
@..................@
@..................@
@..................@
@........@@........@
@........@@........@
@@@@@@@@@@@@@@@@@@@@
